20 10
####################
#                  #
#                  #
########        ####
#                  #
#       ########   #
#                  #
#  ######          #
# P                #
####################

